//MAP CONVERTED BY dmm2tgm.py THIS HEADER COMMENT PREVENTS RECONVERSION, DO NOT REMOVE
"a" = (
/turf/template_noop,
/area/template_noop)
"b" = (
/turf/closed/wall/mineral/titanium,
/area/shuttle/arrival)
"c" = (
/obj/machinery/door/airlock/titanium{
	name = "Arrivals Shuttle Airlock"
	},
/obj/structure/fans/tiny,
/turf/open/floor/plating,
/area/shuttle/arrival)
"d" = (
/obj/effect/spawner/structure/window/shuttle,
/turf/open/floor/plating,
/area/shuttle/arrival)
"e" = (
/obj/effect/turf_decal/stripes/line{
	dir = 1
	},
/obj/effect/turf_decal/stripes/white/line{
	dir = 1
	},
/turf/open/floor/mineral/titanium,
/area/shuttle/arrival)
"f" = (
/turf/open/floor/mineral/titanium,
/area/shuttle/arrival)
"g" = (
/obj/structure/chair/comfy/shuttle{
	dir = 8
	},
/turf/open/floor/mineral/titanium/old/white,
/area/shuttle/arrival)
"h" = (
/obj/machinery/light/small{
	dir = 1
	},
/obj/structure/closet/emcloset,
/obj/effect/turf_decal/stripes/line{
	dir = 1
	},
/obj/effect/turf_decal/stripes/white/line{
	dir = 1
	},
/turf/open/floor/mineral/titanium,
/area/shuttle/arrival)
"i" = (
/obj/structure/closet/firecloset,
/obj/effect/turf_decal/stripes/line{
	dir = 1
	},
/obj/effect/turf_decal/stripes/white/line{
	dir = 1
	},
/turf/open/floor/mineral/titanium,
/area/shuttle/arrival)
"j" = (
/obj/machinery/requests_console{
	department = "Arrival shuttle";
	name = "Arrivals Shuttle console";
	pixel_y = 30
	},
/obj/machinery/light{
	dir = 1
	},
/obj/structure/closet/wardrobe/grey,
/obj/effect/turf_decal/stripes/line{
	dir = 1
	},
/obj/effect/turf_decal/stripes/white/line{
	dir = 1
	},
/turf/open/floor/mineral/titanium/old/white,
/area/shuttle/arrival)
"k" = (
/obj/structure/shuttle/engine/heater{
	dir = 4
	},
/obj/structure/window/reinforced{
	dir = 8
	},
/turf/open/floor/plating/airless,
/area/shuttle/arrival)
"m" = (
/obj/machinery/light{
	dir = 1
	},
/obj/effect/turf_decal/stripes/line{
	dir = 1
	},
/obj/effect/turf_decal/stripes/white/line{
	dir = 1
	},
/turf/open/floor/mineral/titanium,
/area/shuttle/arrival)
"n" = (
/obj/docking_port/mobile/arrivals{
	name = "Snaxi Arrivals Shuttle"
	},
/obj/structure/shuttle/engine/propulsion/burst/right{
	dir = 4
	},
/turf/open/floor/plating/airless,
/area/shuttle/arrival)
"o" = (
/obj/structure/table,
/obj/item/storage/firstaid/regular,
/obj/machinery/light/small,
/obj/effect/turf_decal/stripes/line,
/obj/effect/turf_decal/stripes/white/line,
/turf/open/floor/mineral/titanium,
/area/shuttle/arrival)
"p" = (
/obj/structure/table,
/obj/item/storage/toolbox/emergency,
/obj/effect/turf_decal/stripes/line,
/obj/effect/turf_decal/stripes/white/line,
/turf/open/floor/mineral/titanium,
/area/shuttle/arrival)
"q" = (
/obj/machinery/light,
/obj/effect/turf_decal/stripes/line,
/obj/effect/turf_decal/stripes/white/line,
/turf/open/floor/mineral/titanium,
/area/shuttle/arrival)
"r" = (
/obj/structure/closet/wardrobe/black,
/turf/open/floor/mineral/titanium/old/white,
/area/shuttle/arrival)
"s" = (
/obj/item/radio/intercom{
	name = "Station Intercom (General)";
	pixel_y = -29
	},
/obj/machinery/light,
/obj/structure/closet/wardrobe/black,
/obj/effect/turf_decal/stripes/line,
/obj/effect/turf_decal/stripes/white/line,
/turf/open/floor/mineral/titanium/old/white,
/area/shuttle/arrival)
"t" = (
/obj/effect/turf_decal/stripes/line{
	dir = 1
	},
/turf/open/floor/mineral/titanium,
/area/shuttle/arrival)
"x" = (
/obj/effect/turf_decal/stripes/line,
/obj/effect/turf_decal/stripes/white/line,
/turf/open/floor/mineral/titanium,
/area/shuttle/arrival)
"z" = (
/obj/structure/shuttle/engine/propulsion/burst/right{
	dir = 4
	},
/turf/open/floor/plating/airless,
/area/shuttle/arrival)
"C" = (
/obj/effect/turf_decal/stripes/line,
/turf/open/floor/mineral/titanium,
/area/shuttle/arrival)
"J" = (
/obj/machinery/computer/arcade{
	dir = 8
	},
/turf/open/floor/mineral/titanium/old/white,
/area/shuttle/arrival)
"P" = (
/obj/structure/closet/wardrobe/green,
/turf/open/floor/mineral/titanium/old/white,
/area/shuttle/arrival)

(1,1,1) = {"
a
b
d
d
d
b
a
"}
(2,1,1) = {"
b
b
g
g
g
b
b
"}
(3,1,1) = {"
b
h
f
f
f
o
b
"}
(4,1,1) = {"
b
i
g
g
g
p
b
"}
(5,1,1) = {"
b
e
f
f
f
x
b
"}
(6,1,1) = {"
b
m
g
g
g
q
b
"}
(7,1,1) = {"
d
e
f
f
f
x
d
"}
(8,1,1) = {"
c
t
g
g
g
C
c
"}
(9,1,1) = {"
c
t
f
f
f
C
c
"}
(10,1,1) = {"
b
j
P
J
r
s
b
"}
(11,1,1) = {"
b
k
k
k
k
k
b
"}
(12,1,1) = {"
b
z
z
n
z
z
b
"}
